111111111111111111111111111
1111111E0000000000001111111
11111100000C000000000111111
111110000000000000000011111
111100000000000000000001111
11100000000000000C000000111
110C000000C0000000000000011
100000000000000000000000001
110000000000000000000000011
11100000000000000C000000111
111100000000000000000001111
11111000C000000000000011111
1111110000000000C0000111111
111111100000000000001111111
11111111000000C000011111111
11111111100000000P111111111
111111111111111111111111111
