111111111111111
1100100000000C1
100000111111001
1P00011E0000011
111111111111111
