11111
1B0E1
10001
1P0C1
11111
