111111111111111
11001EB000000C1
100000000011111
1P00011E0000011
111111111111111
