111011111111111
1100100000000C1

100000011111001
1P00010E0000011
111111111111111
