111111111111111
110010000000001
100001111111001
1P00011E0000011
111111111111111
