111111111111111
1100100000000C1
100001111111001
1000011E0000011
111111111111111
