1111111111
100100C0001
100001111111001
1P00011E0011
111111111111111
