111111111111111
1100100000000C0
100000011111001
1P00010E0000011
011111111111111
